雪月	ゆずき
瑞羽	みずは
椛	もみじ
雛多	ひなた
学級	がっきゅう
用紙	ようし
教卓	きょうたく	teacher's desk
置く	おく
内容	ないよう
修行	しゅぎょう
発表	はっぴょう
演劇	えんがき
舞台	ぶたい
科目	かもく
授業	じゅぎょう
実演	じつえん
精一杯	せいいっぱい
商店街	しょうてんがい
成功	せいこう
得意	とくい
役者	やくしゃ
衣替え	ころもがえ
厳密	げんみつ
時期	じき
遅刻	ちこく
流行る	はやる
応募	おうぼ
体育	たいいく
教師	きょうし
洗剤	せんざい
